か	ka
き	ki
く	ku
け	ke
こ	ko
さ	sa
し	si	shi
す	su
せ	se
そ	so
た	ta
ち	ti	chi
つ	tu	tsu
て	te
と	to
な	na
に	ni
ぬ	nu
ね	ne
の	no
は	ha
ひ	hi
ふ	hu	fu
へ	he
ほ	ho
ま	ma
み	mi
む	mu
め	me
も	mo
や	ya
ゆ	yu
よ	yo
ら	ra	la
り	ri	li
る	ru	lu
れ	re	le
ろ	ro	lo
わ	wa
ゐ	wi	wyi
ゑ	we	wye
を	wo
が	ga
ぎ	gi
ぐ	gu
げ	ge
ご	go
ざ	za
じ	zi	ji
ず	zu
ぜ	ze
ぞ	zo
だ	da
ぢ	di
づ	du
で	de
ど	do
ば	ba
び	bi
ぶ	bu
べ	be
ぼ	bo
ぱ	pa
ぴ	pi
ぷ	pu
ぺ	pe
ぽ	po
ゔ	vu
いぇ	ye
うぃ	whi
うぇ	whe
うぉ	who
きゃ	kya
きゅ	kyu
きょ	kyo
ぎゃ	gya
ぎゅ	gyu
ぎょ	gyo
くぁ	kwa	qa
くぃ	kwi	qi
くぇ	kwe	qe
くぉ	kwo	qo
ぐぁ	gwa
しぇ	sye	she
しゃ	sya	sha
しゅ	syu	shu
しょ	syo	sho
じぇ	zye	je
じゃ	zya	ja	jya
じゅ	zyu	ju	jyu
じょ	zyo	jo	jyo
ちぇ	tye	che
ちゃ	tya	cha	cya
ちゅ	tyu	chu	cyu
ちょ	tyo	cho	cyo
ぢぇ	dye
ぢゃ	dya
ぢゅ	dyu
ぢょ	dyo
つぁ	tsa
つぃ	tsi
つぇ	tse
つぉ	tso
てぃ	thi
てゅ	thu
でぃ	dhi
でゅ	dhu
とぅ	twu
どぅ	dwu
にゃ	nya
にゅ	nyu
にょ	nyo
ひゃ	hya
ひゅ	hyu
ひょ	hyo
びゃ	bya
びゅ	byu
びょ	byo
ぴゃ	pya
ぴゅ	pyu
ぴょ	pyo
ふぁ	fa	hwa
ふぃ	fi	hwi
ふぇ	fe	hwe
ふぉ	fo	hwo
ふゅ	fyu	hwyu
みゃ	mya
みゅ	myu
みょ	myo
りゃ	rya
りゅ	ryu
りょ	ryo
ゔぁ	va
ゔぃ	vi
ゔぇ	ve
ゔぉ	vo
ゔゅ	vyu
